law - prawo
entitlement - Uprawnienia
emerge - wyłaniać się
demand -żądanie
extensively - obszernie
commensurate - wspómierny
aware - świadomy 
mandatory - obowiązkowy
intervene - interwieniowac
WIRE - DRUT
hardship - trudność
essential - istotny
haul - zaciąg
humble - pokorny 
pledge - zastaw
sincere - szczery
stampede - popłoch
suitable - odpowiedni 
drowsy - senny
thwarted - udaremniony
settle - rozstrzygać, osiedlać (się)
additional - dodatkowy
come before -  wydarzyć się przed, 
decent      /descent/   dissent
Przyzwoity / zejście / sprzeciw
cutensil -  przyrząd kuchenny o zabawnym lub atrakcyjnym wyglądzie
discern - dostrzegać, zauważać; rozpoznawać
overrate - przeceniać
to be on the breadline -  mieć bardzo małą pensję, wystarczającą jedynie na najbardziej podstawowe rzeczy
relent - zmięknąć, ustępować, łagodnieć
stamina - wytrzymałość
divergence - rozbieżność
a fair whack - reasonable or fair share You need to pay your fair whack of the bill.
DELIVER - DOSTARCZYĆ
resign - rezygnować
approval - zatwierdzenie
do not bother - nie przeszkadzaj
"Adiunkt" to 'assistant professor'; slowo 'adjunct' oznacza "dodatek", "uzupełnienie". 
enwrap - owijać, zawijać
"Grin and bear it" to idiom oznaczający 'robic dobrą minę do złej gry', 'znosić przeciwieństwa losu z uśmiechem'.
hang up - odl
do not disturb - nie przeszkadzac
brisk - quick; active, full of energy; rześki, ożywiony, energiczny, żwawy
elbow-bump - greeting someone by touching the elbows; powitanie przez dotknięcie łokciami
munificent - really generous; szczodry, hojny
(v) a) (of a salesman) to add up purchases and collect money at a store - 
(o sprzedawcy) podliczyć zakupy klienta i wziąć za nie pieniądze; skasować klienta;You'll be checked out at the cash desk over there.


there's no love lost between them
those two people detest or dislike each other very much                 Ci dwaj ludzie nienawidzą lub nie lubią siebie nawzajem

close/not far behind
bardzo szybko po tym, zaraz po tym

to gossip, to tell something (usually a lie) to many people; plotkować, roznosić pogłoski
curse  ; przeklinać, kląć

peradventure -  być może; wątpliwość

gumption - zdrowy rozsądek, odwaga, 

to put a damper on something - zepsuć atmosferę / przyjemność

"Chopping block" to 'pieniek do rąbania', 'pieniek katowski'; "chopping board" to 'deska do krojenia'.


to take the biscuit                   to be the epitome          wprawiać w osłupienie

"Dołeczek w policzku" to 'dimple'.  

leak in - przeciekać

chirp -  świergotać (bird)

"Cove" to 'zatoczka';


roost -  grzęda; siedzieć na grzędzie; gnieździć się

sniffle -  pociągać nosem

as the crow flies  -----      w prostej linii, najkrótszą drogą między dwoma punktami

beat sb to a pulp - zbić kogoś na kwaśne jabłko przen.

role model - osoba stanowiąca wzór godny naśladowania

agitation / aggravation / distortion
podniecenie/ pogorszenie / zniekształcenie


put across      to make (e.g. an idea) understood; wyjaśnić, zdołać wyjaśnić        It won’t be easy to put such decision across to the workers.

cadge from - wyprosić, wyżebrać

mieć nogi w iks" to po angielsku 'to be knock-kneed'.

Self-indulgence, me time, is all I need                               Folgowanie sobie, czas dla siebie, to wszystko, czego potrzebuję. 

bootless = useless ---------- (of a task or undertaking) ineffectual; useless.words at this pass were vain and bootless

be on the air --- nadawać, być na antenie

	
 krótkotrwałość, krótkość; zwięzłość He's a master of brevity. I really admire his works

to miss the boat(bus)      to waste an opportunity;         stracić / przegapić okazję, szansę

fleer -  drwiący uśmiech
in the raw pot - NAGI
gainful - korzystny, zyskowny
to pull the wool over someone's eyes - owijać w bawełnę, oszukiwać, nabierać (kogoś)
hang up - odłożyć słuchawkę 
Be killed outright - ginąć na miejscu
crosstalk - casual conv.
to pull up one's socks              to work harder,      to improve/reform                 pracować ciężej, ulepszać, reformować; zakasać rękawy

to fork out           to pay for someone else's big bill;        uiścic czyjś wysoki rachunek, zapłacić za kogoś, opłacać cos komuś
backpacking  - podróżować z plecakiem
mild; sweet and juicy; ripe; łagodny; soczysty; dojrzały
_________________________________________________________________________________________________________________________________________
"Let's" to skrócona forma "let us". Służy do tworzenia trybu rozkazującego dla liczby mnogiej, np. "Let's talk." ('Porozmawiajmy.').

"Lets" to czasownik ten sam czasownik- "let" ('pozwalać') w trzeciej osobie liczby pojedynczej czasu Present Simple.
_________________________________________________________________________________________________________________________________________
miss (sth/sb) out - opuszczać, utracić
lie doggo pot - ukrywać się, przyczajać się
pointedly - forcibly, evidently; dosadnie, uszczypliwie; wyraźnie, dobitnie
"Genius" to 'geniusz' (słowo to oznacza także 'talent' oraz 'dżina, demona, ducha'). "Genus" to 'rodzaj (biologiczny)'.
clarity	 ---- the quality of being clear; jasność, przejrzystość, klarowność
make up (with sb) - to cease arguing, to forgive each other; godzic się (z kimś) 
to make light work of - ułatwiać sobie pracę, by szła jak po maśle
tub-thumping  - aggressive, violent and forceful; bezceremonialny, napastliwy
before long - niedługo, wkrótce
to say nothing of - nie wspominając (już) o
to wipe the smile off someone's face - to make someone feel less happy or confident(pewni)
shatter - roztrzaskać
nonevent -  niewypał, nieudane wydarzenie
overwork - przepracować się
torpid - obojętny
"Opposite" to ', 'naprzeciw'; "against"- 'wbrew', 'przeciw'.

